1111111111
1P00000001
1000110001
100C00C001
1000110001
1000000001
10C0000C01
1000110001
10000000E1
1111111111