111111111111111111111111111111111111111111111111111
1P0000001000000000000000100000001000000010000000001
1000000010000000100000001000000010000000100000000C1
100000001000000010000000100000000000000010000000001
100000001000000010000000100000001000000010000000001
111101111111101111111011111110111111101111111011111
100000001000000010000000100000001000000010000000001
100000001000000010000000100000001000000010000000001
100000001000000010000000100000001000000010000000001
1000000010000000100000001000000010000000100000000C1
111110111111110111111101111111011111110111111101111
1000000010000000100000001000000010000000100000000C1
100000001000000010000000100000001000000010000000001
100000001000000010000000100000001000000010000000001
100000001000000010000000100000001000000010000000001
111011111110111111101111111011111110111111101111111
100000001000000010000000100000001000000010000000001
100000001000000010000000100000001000000010000000001
100000001000000010000000100000001000000010000000001
1000000010000000100000001000000010000000100000000C1
111111101111111011111110111111101111111011111110111
100000001000000010000000100000001000000010000000001
1000000010000000100000001000000010000000100000000C1
100000001000000010000000100000001000000010000000001
100000001000000010000000100000001000000010000000001
111110111111110111111101111111011111110111111101111
100000001000000010000000100000001000000010000000001
1000000010000000100000001000000010000000100000000C1
100000001000000010000000100000001000000010000000001
100000001000000010000000100000001000000010000000001
110111111101111111011111110111111101111111011111111
100000001000000010000000100000001000000010000000001
100000001000000010000000100000001000000010000000001
1000000010000000100000001000000010000000100000000C1
100000001000000010000000100000001000000010000000001
111111011111110111111101111111011111110111111101111
100000001000000010000000100000001000000010000000001
1000000010000000100000001000000010000000100000000C1
1000000010000000100000001000000010000000100000000C1
100000001000000010000000100000001000000010000000001
111101111111011111110111111101111111011111110111111
1000000010000000100000001000000010000000100000000C1
100000001000000010000000100000001000000010000000001
100000001000000010000000100000001000000010000000001
100000001000000010000000100000001000000010000000001
111011111110111111101111111011111110111111101111111
100000000000000010000000100000001000000010000000001
1000000010000000100000000000000010000000100000000C1
1000000010000000100000001000000010000000000000000E1
111111111111111111111111111111111111111111111111111