1111111111111111111111111111111111111111111111111111
1P00000000000000000000000000000000000000000000000001
1011111110111111101111111011111110111111101111110101
1000000010000000100000001000000010000000100000000101
1011111010111110101111101011111010111110101111100101
1000001010000010100000101000001010000010100000100101
1111101011111010111110101111101011111010111110100101
1000001000000010000010100000101000000010000010100101
1011111011111111111010111111101111111111101011100101
1000000010000000000010000000000000000000001000000101
1011111110111111111111111111111111111111101111110101
10000000000000000000000000000000000000000000000C0101
1011111111111111111111111111111111111111111111110101
1000000000000000000000000000000000000000000000000E01
1111111111111111111111111111111111111111111111111111