11111111111111111111111111111111111111111111111111
1P0000001000000010000000100000001000000010000000001
1000000010000000100000001000000010000000100000000C1
1000000010000000100000001000000010000000100000000C1
1000000010000000100000001000000010000000100000000C1
1111011111111011111110111111101111111011111110111
1000000010000000100000001000000010000000100000000C1
1000000010000000100000001000000010000000100000000C1
1000000010000000100000001000000010000000100000000C1
1000000010000000100000001000000010000000100000000C1
1111101111111101111111011111110111111101111111011
1000000010000000100000001000000010000000100000000C1
1000000010000000100000001000000010000000100000000C1
1000000010000000100000001000000010000000100000000C1
1000000010000000100000001000000010000000100000000C1
1110111111101111111011111110111111101111111011111
1000000010000000100000001000000010000000100000000C1
1000000010000000100000001000000010000000100000000C1
1000000010000000100000001000000010000000100000000C1
1000000010000000100000001000000010000000100000000C1
1111111011111110111111101111111011111110111111101
1000000010000000100000001000000010000000100000000C1
1000000010000000100000001000000010000000100000000C1
1000000010000000100000001000000010000000100000000C1
1000000010000000100000001000000010000000100000000C1
1111101111111101111111011111110111111101111111011
1000000010000000100000001000000010000000100000000C1
1000000010000000100000001000000010000000100000000C1
1000000010000000100000001000000010000000100000000C1
1000000010000000100000001000000010000000100000000C1
1101111111011111110111111101111111011111110111111
1000000010000000100000001000000010000000100000000C1
1000000010000000100000001000000010000000100000000C1
1000000010000000100000001000000010000000100000000C1
1000000010000000100000001000000010000000100000000C1
1111110111111101111111011111110111111101111111011
1000000010000000100000001000000010000000100000000C1
1000000010000000100000001000000010000000100000000C1
1000000010000000100000001000000010000000100000000C1
1000000010000000100000001000000010000000100000000C1
1111011111110111111101111111011111110111111101111
1000000010000000100000001000000010000000100000000C1
1000000010000000100000001000000010000000100000000C1
1000000010000000100000001000000010000000100000000C1
1000000010000000100000001000000010000000100000000C1
1110111111101111111011111110111111101111111011111
1000000010000000100000001000000010000000100000000C1
1000000010000000100000001000000010000000100000000C1
1000000010000000100000001000000010000000100000000E1
1111111111111111111111111111111111111111111111111111