1111111111111111111111111111111111111111111111111111
1P00000000000000000000000000000000000000000000000001
1111111111111111111111111111110111111111111111111101
1000000000000000000000000000000000000000000000000101
1011111111111111111111111111110111111111111111110101
1010000000000000000000000000000000000000000000010101
1010111111111111111111111111110111111111111111010101
1010100000000000000000000000000000000000000001010101
1010101111111111111111111111110111111111111101010101
1010101000000000000000000000000000000000000101010101
1010101011111111111111111111110111111111110101010101
1010101010000000000000000000000000000000010101010101
1010101010111111111111111111110111111111010101010101
1010101010100000000000000000000000000001010101010101
1010101010101111111111111111110111111101010101010101
1010101010101000000000000000000000000101010101010101
1010101010101011111111111111110111110101010101010101
1010101010101010000000000000000000010101010101010101
1010101010101010111111111111110111010101010101010101
1010101010101010100000000000000001010101010101010101
1010101010101010101111111111110101010101010101010101
1010101010101010101000000000000101010101010101010101
1010101010101010101011111111110101010101010101010101
10101010101010101010100000C0000101010101010101010101
1010101010101010101010111111110101010101010101010101
1010101010101010101010000000000101010101010101010101
1010101010101010101010111111111101010101010101010101
1010101010101010101000000000000001010101010101010101
1010101010101010101110111111111111010101010101010101
1010101010101010100000000000000000010101010101010101
1010101010101010111110111111111111110101010101010101
1010101010101010000000000000000000000101010101010101
1010101010101011111110111111111111111101010101010101
1010101010101000000000000000000000000001010101010101
1010101010101111111110111111111111111111010101010101
1010101010100000000000000000000000000000010101010101
1010101010111111111110111111111111111111110101010101
1010101010000000000000000000000000000000000101010101
1010101011111111111110111111111111111111111101010101
1010101000000000000000000000000000000000000001010101
1010101111111111111110111111111111111111111111010101
1010100000000000000000000000000000000000000000010101
1010111111111111111110111111111111111111111111110101
1010000000000000000000000000000000000000000000000101
1011111111111111111110111111111111111111111111111101
10C00000000000000000000000000000000000000000000000E1
1111111111111111111111111111111111111111111111111111